1111111111111111111111111111111111111111
100000100000100000C001000000000000111C01
1100001110001000100000000000111111111001
10000C0000000000000000000000111111110011
100000000111111110000C000000011111100001
1000C0000110000010000000C0000000001000C1
10000000C0000000100000000C00001111100001
100000000000000011110000C000000000000001
10P0C000000000111111000000000000000E0001
1111111111111111111111111111111111111111